NO ./textures/BRICK_6D.xpm
SO ./textures/BRICK_2B.xpm
WE ./textures/BRICK_3B.xpm
EA ./textures/BRICK_3D.xpm

F 173,    189     ,123

1111111111111111111111111
10000000000000100200000001
11111101111211100100000N01
100000000010000001000000001
11111211111111111111111111
10000000000000000000000001
10010010010010010010010001
10001001001001001001001001
10000000000000000000000001
10000010000100001000100001
10010000100000100001000001
10000000000000000000000001
11111111111111111111111111