NO ./textures/BRICK_6D.xpm
SO ./textures/BRICK_2B.xpm
WE ./textures/BRICK_3B.xpm
EA ./textures/BRICK_3D.xpm

F 255, 255, 102
C    255 ,  153   ,   255 

1111
10S1
1211
1001
1121
1001
1211
1001
1121
1001
1211
1001
1121
1001
1211
1001
1121
1001
1211
1001
1121
1001
1211
1001
1121
1001
1211
1001
1121
1001
1211
1001
1121
1001
1211
1001
1121
1001
1211
1001
1121
1001
1211
1001
1121
1001
1211
1001
1121
1001
1211
1001
1121
1001
1211
1001
1121
1001
1211
1001
1121
1001
1211
1001
1121
1001
1211
1001
1121
1001
1211
1001
1121
1001
1211
1001
1121
1001
1211
1001
1121
1001
1211
1001
1121
1001
1211
1001
1121
1001
1211
1001
1121
1001
1211
1001
1121
1001
1211
1001
1121
1001
1211
1001
1121
1001
1211
1001
1121
1001
1211
1001
1121
1001
1211
1001
1121
1001
1211
1001
1121
1001
1211
1001
1121
1001
1211
1001
1121
1001
1211
1001
1121
1001
1211
1001
1121
1001
1211
1001
1121
1001
1211
1001
1121
1001
1211
1001
1121
1001
1111