NO ./path_to_the_north_texture
SO ./path_to_the_south_texture
WE ./path_to_the_west_texture
EA ./path_to_the_east_texture

F 173,    189     ,123
C    20 ,  225   ,   153 
1111111111111111111111111
10000000000000000000000001
100000000011000000000000011
1011000001110000E00000001
10010000000000000000000011111111
111111111011000001110000000000001
100000000011000001110111111111111
11110111111111011100000010001
1111100000000000000000111111
1111111111111111111111111
