NO ./textures/BRICK_6D.xpm
SO ./textures/BRICK_2B.xpm
WE ./textures/BRICK_3B.xpm
EA ./textures/BRICK_3D.xpm

F 173,    189     ,123
C    20 ,  225   ,   153 
1111111111111111111111111
10000000000000000000000001
100000000011000000000000011
1011000001110000000000001
10010000000000000000000011111111
111111111011000001110000000000001
100000000011000001110111111111111
11110111111111S11100000010001
1111100000000000000000111111
1111111111111111111111111
