NO ./textures/BRICK_6D.xpm
SO ./textures/BRICK_2B.xpm
WE ./textures/BRICK_3B.xpm
EA ./textures/BRICK_3D.xpm

F 173,    189     ,123
C    20 ,  225   ,   153 

1111111111111111111111111
10000N0000000000000000W001
10000000000000000000000001
10000000000000000000000001
11111111111111111111111111
