NO          ./textures/BRICK_6D.xpm
SO    ./textures/BRICK_2B.xpm
WE ./textures/BRICK_3B.xpm

F 220,111   , 25 

F 220,111   , 25 

EA ./textures/BRICK_3D.xpm

C 225,111 , 25
C 225,111, 001


    111111  
    1010001
    110001
      1N1
     1011
    101
1111111111
