NO          ./textures/BRICK_6D.xpm
SO    ./textures/BRICK_2B.xpm
WE ./textures/BRICK_3B.xpm



EA ./textures/BRICK_3D.xpm
F 220,111   ,  200
C 225,111 , 

    111111  
    1010001
    110001
      1N1
     1011
    101
1111111111